1000001100
00E0100100
0100001001
0000P00001
0100101111
0000000001